#########################
#                 #     #               
#                      s#               
#          #    ####  ########                             
#          ##      #         #
#     p     ####    #    s#  ####
#    ##           ### #####     # 
#            #  #  ##l####      #
#            s     #######      #
#          #### ####           b#
########  #####l##########    ###
########ll################llll###
#################################