#################
#         #
#         #
##        #
#  p      #
#         #
#         #
#         #
#         #
#         #
#         #

#
#
#
#
#
#
#
#
#
#
#
#
#
#

#
#
#
#
#
#
#
#
#
#
#
#
#
#
#
#
