##########################################################
#       p
#
#
#                        
#                    s   
#                 ###################
#               #####################
#              ######################
##########################################################