#                 #     #
#                       #
#               ####  #######
#          ##      #         #
#     p     ####    #     #   #
#    ##            ########       #
#            #     #######
#             s     #
#           ########
###########################################################
