#                 #     #
#                       #
#               ####  #######
#          ##      #         #
#          ####    #    #   #
#    ##    ####    ########       #
#             ###  #  #######
#    p              #
#           ########
###########################################################
