############################################################
#                 #     #
#                       #
#               ####  #######
#          ##      #         #
#     p     ####    #     #   #
#    ##           #########       #
#            #  #  #######
#            s     #
#          #### ####
########  #####l###########################################
       #ll#