#############
#           #
#           #
##    ##    #
#  p    #   #
#           #
#       #   #
#      ##   #
#     ###   #
#############
