#                 #     #
#                 s    s#
#               ####  #######
#          ##      #         #
#     p    ####    #  s #   #
#    ##    ####    ########       #
#             ###  #  #######
#            s   s  #
#    s      ########
###########################################################
