#################
             
     ##
     ####
     
##### ####
      #######
#############
#############