#                 #     #
#                       #
#               ####  #######
#          ##      #         #
#     p    ####    #    #   #
#    ##    ####    ########       #
#             ###  #  #######
#                   #
#           ########
###########################################################
