#########################################################
#           ##############          ###############
#           ##############    #    #############
#      p    ##############    #     #############
#      ##                ###  #     b###########      
#lllllll#                    ##    #############
#lllllll####  ###  ###  ###  ###################
############ll###ll###ll#############################
######################################################
########################################################